.###S####
.#.####.#
.####.#.#
.##.#.###
.##.#####
E########