#########
##S####E#
.#....###
.#.##.#..
.######..