........
..#####.
.##E###.
.######.
....##..
.S####..
........